[
{
	class: net.slezok.dots.Level,
	description: "plane",
	levelFile: "data/grid.json",
	directions: [2,2,0,2,2,2,2,2,0,2,0,2,0,2,0,2,0,2,
				2,2,2,4,6,4,6,4,6,4,6,4,2,2,2,2,0,2,
				0,2,0,2,4,4,4,4,6,4,6,6,6,6,6,6,4,
				2,4,2,4,2,4,2,4,2,4,6,6,6,6,0,6,0,6,
				0,6,0,6,0,6,0,6,6,6,6,6,6,6,0]
},{
	class: net.slezok.dots.Level,
	description: "tank",
	levelFile: "data/grid.json",
	directions: [4,2,2,4,2,4,2,2,4,2,4,4,4,6,6,6,6,4,2,2,
				2,2,2,2,2,2,2,4,2,4,2,4,4,4,6,4,6,4,6,6,6,
				6,6,6,6,6,6,6,6,6,6,6,6,6,6,6,6,6,6,6,6,6,6,
				6,6,0,6,0,6,0,0,0,2,0,2,0,2,2,2,2,2,2,2,2,2,
				2,2,0,6,6,6,0,6,6,6,6,6,6,6,6,6,4,6,0,0,0,
				2,4,2,2,2,2,2,2,2,2,2,0,2,2,0,2,0,2,2,0,2,2,2]
},{
	class: net.slezok.dots.Level,
	description: "robot",
	levelFile: "data/grid.json",
	directions: [2,2,2,2,4,2,4,4,6,4,4,6,4,4,2,2,2,2,2,4,2,4,4,4,6,
                 4,4,4,4,4,4,2,4,4,6,0,6,4,6,0,0,2,0,0,0,0,0,6,4,4,4,4,
                 6,4,4,4,4,4,4,4,4,4,2,2,2,4,4,6,6,6,6,0,6,0,0,0,0,0,
                 0,6,6,4,4,4,4,4,4,6,4,6,6,6,6,0,0,2,2,2,0,0,0,0,0,0,
                 0,0,0,6,0,0,0,0,6,4,4,4,4,4,2,4,4,6,0,6,4,6,0,0,2,0,
                 0,0,0,0,0,6,0,0,0,2,0,2,2,2,2,2,0,0,6,0,0,6,0,0,2,0]	
},{
	class: net.slezok.dots.Level,
	description: "test",
	levelFile: "data/grid.json",
	directions: [1,2,6,6,6,6,6,6,6,6,6,6,6,6,6,6,6,6,6,6,6,6,6,6,6,6,6,6,6,0,6,0]
}
]